"filename", "language", "R", "comment", "blank", "total"
"/Users/apple/MicrobiomeStat/R/ecam.obj.R", "R", 1, 18, 1, 20
"/Users/apple/MicrobiomeStat/R/generate_alpha_boxplot_long.R", "R", 254, 74, 24, 352
"/Users/apple/MicrobiomeStat/R/generate_alpha_boxplot_single.R", "R", 169, 51, 23, 243
"/Users/apple/MicrobiomeStat/R/generate_alpha_change_boxplot_pair.R", "R", 238, 53, 37, 328
"/Users/apple/MicrobiomeStat/R/generate_alpha_change_test_pair.R", "R", 119, 46, 27, 192
"/Users/apple/MicrobiomeStat/R/generate_alpha_spaghettiplot_long.R", "R", 203, 58, 25, 286
"/Users/apple/MicrobiomeStat/R/generate_alpha_test_long.R", "R", 60, 58, 8, 126
"/Users/apple/MicrobiomeStat/R/generate_alpha_test_pair.R", "R", 59, 79, 11, 149
"/Users/apple/MicrobiomeStat/R/generate_alpha_test_single.R", "R", 70, 41, 13, 124
"/Users/apple/MicrobiomeStat/R/generate_beta_change_boxplot_pair.R", "R", 169, 60, 18, 247
"/Users/apple/MicrobiomeStat/R/generate_beta_change_spaghettiplot_long.R", "R", 212, 79, 28, 319
"/Users/apple/MicrobiomeStat/R/generate_beta_change_test_pair.R", "R", 82, 49, 18, 149
"/Users/apple/MicrobiomeStat/R/generate_beta_ordination_long.R", "R", 197, 59, 9, 265
"/Users/apple/MicrobiomeStat/R/generate_beta_ordination_pair.R", "R", 188, 62, 9, 259
"/Users/apple/MicrobiomeStat/R/generate_beta_ordination_single.R", "R", 214, 67, 16, 297
"/Users/apple/MicrobiomeStat/R/generate_beta_pc_boxplot_long.R", "R", 247, 82, 21, 350
"/Users/apple/MicrobiomeStat/R/generate_beta_pc_change_boxplot_pair.R", "R", 232, 70, 24, 326
"/Users/apple/MicrobiomeStat/R/generate_beta_test_long.R", "R", 63, 40, 9, 112
"/Users/apple/MicrobiomeStat/R/generate_beta_test_pair.R", "R", 51, 47, 8, 106
"/Users/apple/MicrobiomeStat/R/generate_beta_test_single.R", "R", 58, 46, 12, 116
"/Users/apple/MicrobiomeStat/R/generate_taxa_areaplot_long.R", "R", 248, 69, 46, 363
"/Users/apple/MicrobiomeStat/R/generate_taxa_barplot_long.R", "R", 243, 70, 45, 358
"/Users/apple/MicrobiomeStat/R/generate_taxa_barplot_pair.R", "R", 299, 72, 46, 417
"/Users/apple/MicrobiomeStat/R/generate_taxa_barplot_single.R", "R", 316, 74, 49, 439
"/Users/apple/MicrobiomeStat/R/generate_taxa_boxplot_long.R", "R", 373, 108, 37, 518
"/Users/apple/MicrobiomeStat/R/generate_taxa_boxplot_single.R", "R", 308, 100, 33, 441
"/Users/apple/MicrobiomeStat/R/generate_taxa_change_boxplot_pair.R", "R", 347, 88, 38, 473
"/Users/apple/MicrobiomeStat/R/generate_taxa_change_dotplot_pair.R", "R", 319, 88, 38, 445
"/Users/apple/MicrobiomeStat/R/generate_taxa_change_heatmap_long.R", "R", 322, 94, 58, 474
"/Users/apple/MicrobiomeStat/R/generate_taxa_change_heatmap_pair.R", "R", 276, 87, 47, 410
"/Users/apple/MicrobiomeStat/R/generate_taxa_change_scatterplot_pair.R", "R", 260, 85, 41, 386
"/Users/apple/MicrobiomeStat/R/generate_taxa_change_test_pair.R", "R", 238, 82, 42, 362
"/Users/apple/MicrobiomeStat/R/generate_taxa_dotplot_pair.R", "R", 240, 72, 30, 342
"/Users/apple/MicrobiomeStat/R/generate_taxa_dotplot_single.R", "R", 249, 77, 33, 359
"/Users/apple/MicrobiomeStat/R/generate_taxa_heatmap_long.R", "R", 216, 71, 38, 325
"/Users/apple/MicrobiomeStat/R/generate_taxa_heatmap_pair.R", "R", 179, 73, 29, 281
"/Users/apple/MicrobiomeStat/R/generate_taxa_heatmap_single.R", "R", 221, 80, 30, 331
"/Users/apple/MicrobiomeStat/R/generate_taxa_indiv_boxplot_long.R", "R", 329, 105, 37, 471
"/Users/apple/MicrobiomeStat/R/generate_taxa_indiv_boxplot_single.R", "R", 272, 100, 33, 405
"/Users/apple/MicrobiomeStat/R/generate_taxa_indiv_change_boxplot_pair.R", "R", 311, 91, 39, 441
"/Users/apple/MicrobiomeStat/R/generate_taxa_indiv_change_scatterplot_pair.R", "R", 268, 95, 40, 403
"/Users/apple/MicrobiomeStat/R/generate_taxa_indiv_spaghettiplot_long.R", "R", 281, 68, 30, 379
"/Users/apple/MicrobiomeStat/R/generate_taxa_spaghettiplot_long.R", "R", 285, 67, 35, 387
"/Users/apple/MicrobiomeStat/R/generate_taxa_test_long.R", "R", 128, 63, 24, 215
"/Users/apple/MicrobiomeStat/R/generate_taxa_test_pair.R", "R", 129, 55, 23, 207
"/Users/apple/MicrobiomeStat/R/generate_taxa_test_single.R", "R", 172, 62, 26, 260
"/Users/apple/MicrobiomeStat/R/linda.R", "R", 320, 203, 58, 581
"/Users/apple/MicrobiomeStat/R/load_data_obj_count.R", "R", 80, 35, 11, 126
"/Users/apple/MicrobiomeStat/R/load_data_obj_metadata.R", "R", 68, 35, 11, 114
"/Users/apple/MicrobiomeStat/R/load_data_obj_taxonomy.R", "R", 29, 35, 12, 76
"/Users/apple/MicrobiomeStat/R/load_data_obj_tree.R", "R", 26, 35, 12, 73
"/Users/apple/MicrobiomeStat/R/mStat_aggregate_by_taxonomy.R", "R", 39, 36, 10, 85
"/Users/apple/MicrobiomeStat/R/mStat_aggregate_data.R", "R", 70, 30, 8, 108
"/Users/apple/MicrobiomeStat/R/mStat_calculate_PC.R", "R", 24, 29, 4, 57
"/Users/apple/MicrobiomeStat/R/mStat_calculate_alpha_diversity.R", "R", 17, 19, 6, 42
"/Users/apple/MicrobiomeStat/R/mStat_calculate_beta_diversity.R", "R", 55, 35, 14, 104
"/Users/apple/MicrobiomeStat/R/mStat_combine_data.R", "R", 33, 16, 11, 60
"/Users/apple/MicrobiomeStat/R/mStat_convert_DESeqDataSet_to_data_obj.R", "R", 22, 37, 8, 67
"/Users/apple/MicrobiomeStat/R/mStat_convert_DGEList_to_data_obj.R", "R", 14, 36, 6, 56
"/Users/apple/MicrobiomeStat/R/mStat_convert_MRExperiment_to_data_obj.R", "R", 22, 35, 8, 65
"/Users/apple/MicrobiomeStat/R/mStat_convert_MultiAssayExperiment_to_data_obj.R", "R", 21, 39, 8, 68
"/Users/apple/MicrobiomeStat/R/mStat_convert_SummarizedExperiment_to_data_obj.R", "R", 22, 35, 7, 64
"/Users/apple/MicrobiomeStat/R/mStat_convert_phyloseq_to_data_obj.R", "R", 39, 32, 9, 80
"/Users/apple/MicrobiomeStat/R/mStat_generate_report_change_pair.R", "R", 371, 85, 62, 518
"/Users/apple/MicrobiomeStat/R/mStat_generate_report_long.R", "R", 554, 131, 91, 776
"/Users/apple/MicrobiomeStat/R/mStat_generate_report_pair.R", "R", 378, 113, 74, 565
"/Users/apple/MicrobiomeStat/R/mStat_generate_report_single.R", "R", 362, 112, 75, 549
"/Users/apple/MicrobiomeStat/R/mStat_import_biom_as_data_obj.R", "R", 72, 45, 8, 125
"/Users/apple/MicrobiomeStat/R/mStat_import_dada2_as_data_obj.R", "R", 27, 58, 8, 93
"/Users/apple/MicrobiomeStat/R/mStat_import_mothur_as_data_obj.R", "R", 132, 235, 18, 385
"/Users/apple/MicrobiomeStat/R/mStat_import_qiime2_as_data_obj.R", "R", 107, 107, 26, 240
"/Users/apple/MicrobiomeStat/R/mStat_normalize_data.R", "R", 69, 36, 9, 114
"/Users/apple/MicrobiomeStat/R/mStat_process_time_variable.R", "R", 55, 33, 6, 94
"/Users/apple/MicrobiomeStat/R/mStat_rarefy_data.R", "R", 32, 31, 10, 73
"/Users/apple/MicrobiomeStat/R/mStat_remove_feature.R", "R", 33, 40, 16, 89
"/Users/apple/MicrobiomeStat/R/mStat_subset_data.R", "R", 45, 54, 14, 113
"/Users/apple/MicrobiomeStat/R/mStat_subset_dist.R", "R", 25, 56, 6, 87
"/Users/apple/MicrobiomeStat/R/mStat_summarize_data_obj.R", "R", 278, 74, 40, 392
"/Users/apple/MicrobiomeStat/R/mStat_update_meta_data.R", "R", 17, 42, 7, 66
"/Users/apple/MicrobiomeStat/R/mStat_update_sample_name.R", "R", 10, 39, 6, 55
"/Users/apple/MicrobiomeStat/R/mStat_validate_data.R", "R", 27, 27, 7, 61
"/Users/apple/MicrobiomeStat/R/peerj32.obj.R", "R", 1, 18, 1, 20
"/Users/apple/MicrobiomeStat/R/subset_T2D.obj.R", "R", 1, 12, 2, 15
"/Users/apple/MicrobiomeStat/R/update_data_obj_count.R", "R", 30, 21, 11, 62
"/Users/apple/MicrobiomeStat/R/visualization_related.R", "R", 144, 118, 39, 301
"Total", "-", 13386, 5444, 2047, 20877